level 1
next_level assets/level_2.map
next_level assets/level_3.map
map
# # L # # # # # # # -1
# 0 K 0 0 0 0 0 0 # -1
# B 0 W 0 0 0 0 0 D -1
# 0 0 0 0 0 0 0 0 # -1
# 0 0 0 0 0 0 0 0 # -1
# 0 0 0 0 0 0 0 0 # -1
# 0 0 0 S 0 0 0 0 # -1
# # # # # # # # # # -2